0000000000000000000000000000000000000000
0                              EEEEEEEE0
0                              EEEEEEEE0
0                              EEEEEEEE0
0                              EEEEEEEE0
0                              000000000
0                                      0
0         000000000                    0
0                                      0
0                  000000000           0
0                                      0
0    000000000                         0
0                                      0
0             X                        0
0000000000000000000000000000000000000000
