0000000000000000000000000000000000000000
0   0                              EEEE0
0   0                              EEEE0
0   0                              EEEE0
0   0  0000            00000       00000
0   0                  0               0
0   0                                  0
0   0                                  0
0   0        00000                     0
0   0            0              000    0
0   0                             0    0
0   0                  0000            0
0   0                                  0
0   0    0000                          0
0   0                                  0
0   0            0                     0
0   0                                  0
0   0                                  0
0                 000000               0
0                                   0000
0         X                            0
0000000000000000000000000000000000000000
