0000000000000000000000000000000000000000
0XXX                                   0
0XXX                                   0
000000                                 0
0      KKKKK                           0
0      00000            0000           0
0                                      0
0               0000                   0
0        KKK                           0
0        000             0000          0
0                                      0
0    0000        0000             000000
0    0                            000000
0    0           KKKKKK                0
0    0           000000          EEEE  0
0    0                           EEEE  0
0000000000000000000000000000000000000000