0000000000000000000000000000000000000000
0                0XXXXX                0
0                0XXXXX                0
0                0XXXXX                0
0                000000                0
0                     0                0
0                     0                0
0                     0                0
0                     0                0
0                000000                0
0                              KKK     0
0                              000     0
0                                      0
0            K                         0
0           K0K                        0
0            K   KKKK                  0
0                0000000    00000000   0
0    K00K        0000            KKK   0
0    K00K        0000                  0
0                0000                  0
0                       KKKK           0
0                       0000           0
0                                      0
0                                      0
0             KKK                      0
0            0000                      0
0KKKKKKKKKKKK0                         0
00000000000000                 000     0
0                              000     0
0              KKK             000     0
0              K0K                     0
0              KKK     00              0
0                      KK              0
0                                      0
0                                      0
0                                      0
0                                      0
0                                      0
0                                      0
0                                      0
0KKKK0EEEE0KKKKKKKKKKKKKKKKKKKKKKKKKKKK0
0KKKK0EEEE0KKKKKKKKKKKKKKKKKKKKKKKKKKKK0
0KKKK0EEEE0KKKKKKKKKKKKKKKKKKKKKKKKKKKK0
0000000000000000000000000000000000000000
