00000000000000000000000000000000000000000000000000000000000000000000000000000000
0XXX           0                                                               0
0XXX           0                                                               0
0000           0       00000000000000000000000                  00000000    0000
0              0       0                    0                   0              0
0      0000    0       0                    0                   0              0
0              0       0       0000         0                   0       0000   0
0              0       0                    0                   0              0
0      0000    0       0       KKKK         0                   0       KKKK   0
0              0       0       0000         0                   0       0000   0
0              0       0                    0                   0              0
0      000000000       0                    000000000000        0              0
0                      0                                        0              0
0                      000000000000000000000000000000000000000000              0
0                                                                              0
0000000                                                                        0
0                                                                              0
0      KKKKKKKKKKKKKKKKKKKKKKKKKKKKKKKKKKKKKKKKKKKKKKKKKKKKKKKKKKK             0
0      00000000000000000000000000000000000000000000000000000000000             0
0                                                                              0
0                                                                              0
0EEEE                                                                          0
0EEEE                                                                          0
00000000000000000000000000000000000000000000000000000000000000000000000000000000