00000000000000000000000000000000000000000000000000000000000000000000000000000000
0                                                                          EEEE0
0                                                                          EEEE0
0                                                                        000000
0                                                             000000           0
0                                                   000000                     0
0                                         000000                               0
0                               000000                                         0
0                     000000                                                   0
0           000000                                                             0
0    XXX                                                                       0
0    XXX                                                                       0
0    000000                                                                    0
0    K                                                                         0
0    K               000000                                                    0
0    K                         000000                                          0
0    K                                   000000                                0
0    K                                             000000                      0
0    K                                                       000000            0
0    K                                                                 000000  0
0    K                                                                         0
0    K                                                                         0
0    K                                                                         0
00000000000000000000000000000000000000000000000000000000000000000000000000000000