0000000000000000000000000000000000000000
0XXX                                   0
0XXX                                   0
00000                                  0
0                                      0
0      0000                            0
0                                      0
0              0000                    0
0                                      0
0                      0000            0
0                                      0
0    KKKKK    KKKKK    KKKKK           0
0    00000    00000    00000           0
0                                      0
0                                EEEE  0
0              0000              EEEE  0
0000000000000000000000000000000000000000